v,p,p,p,p,p,p,p,p,v
v,p,p,p,p,p,v,v,v,v
v,p,p,p,p,p,v,p,p,v
v,p,v,v,v,p,v,v,v,v
v,p,v,p,v,p,v,p,p,v
v,v,v,p,v,v,v,p,p,v
v,p,p,p,v,p,v,p,p,v
v,p,p,p,v,p,v,v,p,v
v,v,v,v,v,v,v,v,v,v
v,p,p,p,p,p,p,p,p,v
